梅花枪法	梅花槍法
三柴剑法	三柴劍法
长拳	長拳
连环双刀	連環雙刀
判官笔法	判官筆法
虹气长空	虹氣長空
传功	傳功
星楼月影	星樓月影
握针	握針
清心静气	清心靜氣
春泥护花	春泥護花
清风垂露	清風垂露
花语酥心	花語酥心
水月无间	水月無間
提针	提針
锋针	鋒針
彼针	彼針
长针	長針
阳明指	陽明指
商阳指	商陽指
厥阴指	厥陰指
芙蓉并蒂	芙蓉並蒂
钟林毓秀	鐘林毓秀
兰摧玉折	蘭摧玉折
般若诀	般若訣
太阴指	太陰指
韦陀献杵	韋陀獻杵
横扫六合	橫掃六合
摩诃无量	摩訶無量
捕风式	捕風式
抱残式	抱殘式
抢珠式	搶珠式
拿云式	拿雲式
罗汉金身	羅漢金身
金刚怒目	金剛怒目
五蕴皆空	五蘊皆空
大狮子吼	大獅子吼
锻骨诀	鍛骨訣
舍身诀	捨身訣
轮回诀	輪回訣
擒龙诀	擒龍訣
无相诀	無相訣
两仪化形	兩儀化形
九转归一	九轉歸一
太极无极	太極無極
天地无极	天地無極
剑飞惊天	劍飛驚天
万剑归宗	萬劍歸宗
坐忘无我	坐忘無我
韬光养晦	韜光養晦
夺魄	奪魄
梯云纵	梯雲縱
凭虚御风	憑虛禦風
生太极	生太極
破苍穹	破蒼穹
三环套月	三環套月
无我无剑	無我無劍
大道无术	大道無術
四象轮回	四象輪回
六合独尊	六合獨尊
镇山河	鎮山河
转乾坤	轉乾坤
穿云	穿雲
定军	定軍
龙吟	龍吟
疾如风	疾如風
龙牙	龍牙
啸如虎	嘯如虎
灭	滅
破坚阵	破堅陣
战八方	戰八方
断魂刺	斷魂刺
任驰骋	任馳騁
御	禦
沧月	滄月
鸣凤	鳴鳳
饮露	飲露
同归	同歸
养气	養氣
千斤坠	千斤墜
军临	軍臨
金汤	金湯
当关	當關
林栖	林棲
峦复	巒復
心问	心問
名动四方	名動四方
灵犀	靈犀
余悸	餘悸
帝骖龙翔	帝驂龍翔
婆罗门	婆羅門
剑影留痕	劍影留痕
剑心通明	劍心通明
龙池乐	龍池樂
雨霖铃	雨霖鈴
鹊踏枝	鵲踏枝
翔鸾舞柳	翔鸞舞柳
风袖低昂	風袖低昂
上元点鬟	上元點鬟
剑神无我	劍神無我
剑气长江	劍氣長江
剑主天地	劍主天地
剑转流云	劍轉流雲
剑灵寰宇	劍靈寰宇
回雪飘摇	回雪飄搖
左旋右转	左旋右轉
繁音急节	繁音急節
王母挥袂	王母揮袂
满堂势	滿堂勢
冻逝	凍逝
锻骨	鍛骨
不坏	不壞
易筋经	易筋經
活络	活絡
易经	易經
人剑合一	人劍合一
断风	斷風
太虚	太虛
叠刃	疊刃
骑御	騎禦
自绝经脉	自絕經脈
九襄地玄阵	九襄地玄陣
心无	心無
联袂	聯袂
闭阵	閉陣
风雨	風雨
一重粗识	一重粗識
五重游刃	五重遊刃
破势	破勢
绵云	綿雲
生阳	生陽
灵剑	靈劍
孤剑	孤劍
无色	無色
执迷	執迷
划天	劃天
折冲	折衝
游龙	游龍
腾兔	騰兔
潜渊	潛淵
立鹊	立鵲
活脉	活脈
玉虹贯日	玉虹貫日
平湖断月	平湖斷月
九溪弥烟	九溪彌煙
玉泉鱼跃	玉泉魚躍
黄龙吐翠	黃龍吐翠
梦泉虎跑	夢泉虎跑
云飞玉皇	雲飛玉皇
霞流宝石	霞流寶石
峰插云景	峰插雲景
风来吴山	風來吳山
听雷	聽雷
惊涛	驚濤
啸日	嘯日
莺鸣柳	鶯鳴柳
风吹荷	風吹荷
测试技能	測試技能
梅隐香	梅隱香
云栖松	雲棲鬆
问水	問水
灵蕴	靈蘊
碧环	碧環
御天	禦天
彤云	彤雲
危楼	危樓
松涛	松濤
四季剑法	四季劍法
蝎心	蠍心
蟾啸	蟾嘯
千丝	千絲
夺命蛊	奪命蠱
迷心蛊	迷心蠱
枯残蛊	枯殘蠱
眠蛊	眠蠱
幻蛊	幻蠱
凤凰蛊	鳳凰蠱
圣蝎引	聖蠍引
灵蛇引	靈蛇引
风蜈引	風蜈引
蛊虫献祭	蠱蟲獻祭
蛊虫狂暴	蠱蟲狂暴
女娲补天	女媧補天
蛊惑众生	蠱惑眾生
冰蚕牵丝	冰蠶牽絲
仙王蛊鼎	仙王蠱鼎
娲颜	媧顏
金刚诀	金剛訣
三世诸佛	三世諸佛
归去来棍	歸去來棍
乘龙箭	乘龍箭
霹雳	霹靂
渊	淵
快雪时晴	快雪時晴
乱洒青荷	亂灑青荷
利针	利針
听风吹雪	聽風吹雪
五方行尽	五方行盡
紫气东来	紫氣東來
剑冲阴阳	劍衝陰陽
八荒归元	八荒歸元
剑破虚空	劍破虛空
圣手织天	聖手織天
妙舞神扬	妙舞神揚
化血镖	化血鏢
迷神钉	迷神釘
梅花针	梅花針
暴雨梨花针	暴雨梨花針
心无旁骛	心無旁騖
夺魄箭	奪魄箭
飞星遁影	飛星遁影
蚀肌弹	蝕肌彈
天绝地灭	天絕地滅
千机变	千機變
暗藏杀机	暗藏殺機
惊鸿游龙	驚鴻游龍
荆天棘地	荊天棘地
鸟翔碧空	鳥翔碧空
罡风镖法	罡風鏢法
图穷匕见	圖窮匕見
弩箭制造	弩箭製造
机关制造	機關製造
玄水蛊	玄水蠱
幽月轮	幽月輪
银月斩	銀月斬
赤日轮	赤日輪
烈日斩	烈日斬
圣明佑	聖明佑
净世破魔击	淨世破魔擊
极乐引	極樂引
贪魔体	貪魔體
暗尘弥散	暗塵彌散
生灭予夺	生滅予奪
驱夜断愁	驅夜斷愁
戒火斩	戒火斬
慈悲愿	慈悲願
朝圣言	朝聖言
双人同骑	雙人同騎
无明魂锁	無明魂鎖
拨狗朝天	撥狗朝天
棒打狗头	棒打狗頭
天下无狗	天下無狗
龙跃于渊	龍躍於淵
时乘六龙	時乘六龍
见龙在田	見龍在田
龙战于野	龍戰於野
龙啸九天	龍嘯九天
烟雨行	煙雨行
醉逍遥	醉逍遙
横打双獒	橫打雙獒
恶狗拦路	惡狗攔路
犬牙交错	犬牙交錯
狂龙乱舞	狂龍亂舞
蛟龙翻江	蛟龍翻江
双龙取水	雙龍取水
龙游天地	龍遊天地
龙腾五岳	龍騰五嶽
神龙摆尾	神龍擺尾
飞龙在天	飛龍在天
亢龙有悔	亢龍有悔
神龙降世	神龍降世
扬戈	揚戈
龙啸	龍嘯
风虎	風虎
出云	出雲
飞将	飛將
飞遁	飛遁
夜征	夜徵
坚韧	堅韌
仗剑	仗劍
龙痕	龍痕
坚城	堅城
狮心	獅心
将威	將威
旗渊	旗淵
毫发无遗	毫髮無遺
回肠荡气	回腸蕩氣
绝伦逸群	絕倫逸群
百步穿杨	百步穿楊
战不旋踵	戰不旋踵
积重难返	積重難返
潜催	潛催
弹指	彈指
烟霞	煙霞
梦歌	夢歌
弹梦	彈夢
束发	束髮
风烟翠	風煙翠
渐催	漸催
月华	月華
述怀	述懷
生脉	生脈
千机	千機
不舍	不捨
金针	金針
挫锐	挫銳
独笑	獨笑
无我	無我
无意	無意
同尘	同塵
霜锋	霜鋒
无极	無極
雾锁	霧鎖
无形	無形
伤春	傷春
新妆	新妝
珑韵	瓏韻
惊寒	驚寒
双鸾	雙鸞
蝶恋	蝶戀
辞致	辭致
冰华	冰華
莫辞	莫辭
倾城	傾城
晚阳	晚陽
散余霞	散餘霞
断灭	斷滅
华香	華香
善护	善護
缘断	緣斷
执迷不返	執迷不返
生缘	生緣
天龙音	天龍音
色空体	色空體
离境	離境
大觉	大覺
无尘	無塵
千钧	千鈞
禅临	禪臨
不动	不動
禅语	禪語
镇魔	鎮魔
贞护	貞護
烧石	燒石
龙池	龍池
淘尽	淘盡
清风	清風
怜光	憐光
踏雪寻梅	踏雪尋梅
映波锁澜	映波鎖瀾
遥看	遙看
浮云	浮雲
辉耀红尘	輝耀紅塵
无幽不烛	無幽不燭
无往不复	無往不復
腾焰飞芒	騰焰飛芒
血泪成悦	血淚成悅
镇魔极道	鎮魔極道
火舞长空	火舞長空
洞若观火	洞若觀火
天地诛戮	天地誅戮
寂灭劫灰	寂滅劫灰
幽隐尘迹	幽隱塵跡
恶秽满路	惡穢滿路
月尽天明	月盡天明
一线生机	一線生機
迅电流光	迅電流光
惊心裂胆	驚心裂膽
夺魄之威	奪魄之威
流星赶月	流星趕月
裂石穿云	裂石穿雲
雷动九天	雷動九天
清夜裁云	清夜裁雲
无声骤雨	無聲驟雨
秋风散影	秋風散影
实腹	實腹
期声	期聲
千里无痕	千里無痕
雾外江山	霧外江山
天魔蚀肌	天魔蝕肌
劫数难逃	劫數難逃
蚀肌之伤	天風汲雨
弩击急骤	弩擊急驟
弩击轰雷	弩擊轟雷
天罗地网	天羅地網
千机之威	千機之威
千机神速	千機神速
千机巨搫	千機巨搫
击搏挽裂	擊搏挽裂
牧云	牧雲
长征	長征
虎贲	虎賁
岳峙	嶽峙
破楼兰	破樓蘭
青阳	青陽
绝顶	絕頂
斩岳	斬嶽
气爽	氣爽
山重水复	山重水複
夜风	夜風
云体	雲體
层云	層雲
碧归	碧歸
残雪	殘雪
生莲	生蓮
长依	長依
两生	兩生
霜风	霜風
冥泽	冥澤
春辞	春辭
音韵	音韻
无量波罗	無量波羅
净果	淨果
无量	無量
众嗔	眾嗔
蝎毒	蠍毒
无常	無常
凄切	悽切
随风	隨風
不鸣	不鳴
枭泣	梟泣
尾后针	尾後針
蝉蜕	蟬蛻
圣涌	聖湧
圣手	聖手
冰体	冰體
柔丝	柔絲
织雾	織霧
圣咏	聖詠
冰丝	冰絲
渊兮	淵兮
纳精	納精
飞天	飛天
流离	流離
兰舟	蘭舟
无明业火	無明業火
秽身浴露	穢身浴露
贪魔伐罪	貪魔伐罪
超凡入圣	超凡入聖
极本溯源	極本溯源
无量妙境	無量妙境
清净众生	清淨眾生
万念俱寂	萬念俱寂
日月同辉	日月同輝
圣法光明	聖法光明
善恶如梦	善惡如夢
食肉众生	食肉眾生
圣光明	聖光明
随物	隨物
寂灭	寂滅
心剑两望	心劍兩望
归寂无息	歸寂無息
圣火燃心	聖火燃心
折冲厌难	折衝厭難
解纷	解紛
纵遇善缘	縱遇善緣
除荡旷劫	除蕩曠劫
极乐普渡	極樂普渡
斩火	斬火
神机千算	神機千算
战心	戰心
临风	臨風
乘云	乘雲
玄黄	玄黃
御龙	禦龍
复礼	復禮
雨龙	雨龍
无疆	無疆
战龙	戰龍
贞固	貞固
驯致	馴致
云龙	雲龍
飞龙	飛龍
越渊	越淵
降龙	降龍
满盈	滿盈
自强	自強
追远	追遠
穷尽九泉	窮盡九泉
生发	生髮
祭礼	祭禮
虫兽	蟲獸
离争	離爭
风身	風身
冰蚕诀	冰蠶訣
蝶戏水	蝶戲水
狂风暴雨	狂風暴雨
奥妙无穷	奧妙無窮
扬威天下	揚威天下
蚀肌化血	蝕肌化血
梨花带雨	梨花帶雨
无惑	無惑
妙镜惊寂	妙鏡驚寂
伐魔忏罪	伐魔懺罪
万世不竭	萬世不竭
天隼击	天隼擊
感时曲终	感時曲終
扶摇直上	扶搖直上
蹑云逐月	躡雲逐月
迎风回浪	迎風回浪
凌霄揽胜	凌霄攬勝
瑶台枕鹤	瑤臺枕鶴
后撤	後撤
无惧	無懼
盾压	盾壓
盾击	盾擊
盾墙	盾牆
盾飞	盾飛
闪刀	閃刀
斩刀	斬刀
绝刀	絕刀
残楼	殘樓
万仞	萬仞
炼狱	煉獄
绝返	絕返
雄峦	雄巒
步临	步臨
胜前	勝前
强袭	強襲
出尘	出塵
慑服	懾服
恋战	戀戰
铿锵	鏗鏘
坚铁	堅鐵
分山劲	分山勁
铁骨衣	鐵骨衣
隐刀	隱刀
战毅	戰毅
千险	千險
愤恨	憤恨
权门	權門
卷云	捲雲
潜心	潛心
从容	從容
百炼	百鍊
飞瀑	飛瀑
难行	難行
盾抛	盾拋
盾挡	盾擋
雷云	雷雲
残裂	殘裂
捍卫	捍衛
戒备	戒備
振奋	振奮
鸿鹊	鴻鵲
夏风	夏風
宫	宮
阳春白雪	陽春白雪
笑傲光阴	笑傲光陰
云生结海	雲生結海
青霄飞羽	青霄飛羽
孤影化双	孤影化雙
疏影横斜	疏影橫斜
清绝影歌	清絕影歌
莫问	莫問
清音长啸	清音長嘯
迴梦逐光	回夢逐光
寿生	壽生
一指回鸾	一指回鸞
号钟	號鍾
红隙	紅隙
掷杯	擲杯
飞帆	飛帆
犹香	猶香
温语	溫語
石间意	石間意
师襄	師襄
变宫	變宮
变徵	變徵
气略	氣略
井仪	井儀
唳风	唳風
长清	長清
广雅	廣雅
无尽藏	無盡藏
参连	參連
棋宫	棋宮
秋鸿	秋鴻
自赏	自賞
谪仙	謫仙
寸光阴	寸光陰
书离	書離
织心	綠綺
鹿鸣	鹿鳴
蔚风	蔚風
楚济	楚濟
天音知脉	天音知脈
贯珠	貫珠
辟寒	闢寒
凭风	憑風
如风	如風
饮江	飲江
无咎	無咎
踏莲	踏蓮
砚悬	硯懸
摇柳	搖柳
雪弃	雪棄
殇未悔	殤未悔
宿角生辉	宿角生輝
华彩若英	華彩若英
辟滞扈沙	闢滯扈沙
圣浴明心	聖浴明心
劳心忡寿	勞心忡壽
降灵尊	降靈尊
驱夷逐法	驅夷逐法
轻妒	輕妒
仪凤	儀鳳
险韵	險韻
六识	六識
五识	五識
灵越	靈越
静色	靜色
独觉	獨覺
反岳	反嶽
温邑	溫邑
飞光流转	飛光流轉
叠泉	疊泉
于役	於役
驰骋	馳騁
载戎	載戎
戟胜	戟勝
负阴	負陰
静笃	靜篤
虚极	虛極
玄门	玄門
抱阳	抱陽
规焉	規焉
蔑视	蔑視
卧沙	臥沙
肃驾	肅駕
骇日	駭日
亮节	亮節
妙手连环	妙手連環
逐一击破	逐一擊破
瑕草无霜	瑕草無霜
冻雨寒愁	凍雨寒愁
侵火动旌	侵火動旌
雷甲三铉	雷甲三鉉
乱絮	亂絮
争簇	爭簇
采珍	採珍
入圣	入聖
盏萤	盞螢
刻梦	刻夢
捣衣	搗衣
松舍问霞	鬆舍問霞
心火叹	心火嘆
御鸿于天	禦鴻於天
临捕	臨捕
折叶笼花	折葉籠花
南风吐月	南風吐月
开兑	開兌
平笃	平篤
龙血	龍血
琴音共鸣	琴音共鳴
寒啸千军	寒嘯千軍
歌尽影生	歌盡影生
号令三军	號令三軍
蚀心蛊	蝕心蠱
迷仙引梦	迷仙引夢
破重围	破重圍
二业依缘	二業依緣
舍身弘法	捨身弘法
扬旌沙场	揚旌沙場
宽野	寬野
催盏	催盞
雾雨	霧雨
霜风刀法	霜風刀法
刀啸风吟	刀嘯風吟
龙骧虎步	龍驤虎步
醉斩白蛇	醉斬白蛇
松烟竹雾	松煙竹霧
秀明尘身	秀明塵身
楚河汉界	楚河漢界
踏宴扬旗	踏宴揚旗
割据秦宫	割據秦宮
雷走风切	雷走風切
项王击鼎	項王擊鼎
封渊震煞	封淵震煞
坚壁清野	堅壁清野
上将军印	上將軍印
龙息	龍息
息声	息聲
啸吒	嘯吒
击瑕	擊瑕
腾雾	騰霧
雾晓	霧曉
斩纷	斬紛
连兵	連兵
沧雪	滄雪
行泽	行澤
归酣	歸酣
业海罪缚	業海罪縛
风荷	風荷
擒龙六斩	擒龍六斬
尘息	塵息
重烟	重煙
抱残	抱殘
心执	心執
空识	空識
心镜	心鏡
杀机断魂	殺機斷魂
阳关	陽關
辟海	闢海
绝期	絕期
闹须弥	鬧須彌
云凌	雲凌
无欲	無慾
风逝	風逝
物我两忘	物我兩忘
吐故纳新	吐故納新
凌太虚	凌太虛
缩地	縮地
冲阴阳	衝陰陽
飞萍	飛萍
余寒映日	餘寒映日
击水	擊水
千驰	千馳
千回百转	千回百轉
昂如岳	昂如嶽
卸元归魂	卸元歸魂
春脉	春脈
蚀月	蝕月
轻鸿	輕鴻
少阳指	少陽指
花语	花語
净身明礼	淨身明禮
秽孽如形	穢孽如形
忏罪归清	懺罪歸清
祭灵	祭靈
蝎噬	蠍噬
厌高	厭高
点苍	點蒼
鹤归孤山	鶴歸孤山
云台	雲臺
分澜	分瀾
固灵	固靈
鸣金	鳴金
风入松	風入松
飞竹	飛竹
缠竹	纏竹
子母飞爪	子母飛爪
乘龙戏水	乘龍戲水
流电	流電
灵蛊	靈蠱
骁勇	驍勇
劲风	勁風
飞袂	飛袂
镜花	鏡花
狮啸	獅嘯
百战	百戰
伏明众生	伏明眾生
明光恒照	明光恆照
秘影诡行	秘影詭行
日月齐光	日月齊光
飞鸢逐月	飛鳶逐月
千秋万劫	千秋萬劫
长致	長致
良兽	良獸
蛊影	蠱影
缠心	纏心
噬蛊	噬蠱
御风	禦風
万物	萬物
啸影	嘯影
别鹤	別鶴
云汉	雲漢
啖灵	啖靈
故长	故長
归寂道	歸寂道
庄周梦	莊周夢
蝶隐	蝶隱
思议	思議
蓬莱	蓬萊
飘遥伞击	飄遙傘擊
击水三千	擊水三千
木落雁归	木落雁歸
翼绝云天	翼絕雲天
驭羽骋风	馭羽騁風
游龙步	游龍步
逍遥游	逍遙遊
跃潮斩波	躍潮斬波
翔极碧落	翔極碧落
海运南冥	海運南冥
溟海御波	溟海禦波
逐波灵游	逐波靈遊
定波砥澜	定波砥瀾
振翅图南	振翅圖南
疾电叱羽	疾電叱羽
逸尘步虚	逸塵步虛
江汉	江漢
渊壑	淵壑
昆山	崑山
游心	遊心
藏锋	藏鋒
倾盖	傾蓋
无涯	無涯
驰行	馳行
戍卫	戍衛
九霄风雷	九霄風雷
百转千回	百轉千回
鸿渐于飞	鴻漸于飛
金虹击殿	金虹擊殿
点墨江山	點墨江山
一苇渡江	一葦渡江
云体风身	雲體風身
堕天沉渊	墮天沉淵
飞鸢泛月	飛鳶泛月
雷影风踪	雷影風蹤
御空翔波	禦空翔波
凝气	凝氣
冯夷	馮夷
辰极	辰極
征夷	徵夷
苍梧	蒼梧
伞意	傘意
乘龙	乘龍
遥思	遙思
兰棹	蘭棹
奋翼	奮翼
怅归	悵歸
穹庐	穹廬
梦悠	夢悠
鸿轨	鴻軌
跃潮	躍潮
横绝	橫絕
时移	時移
剑势	劍勢
激奋	激奮
下马牵行	下馬牽行
霜天剑泠	霜天劍泠
遥归	遙歸
吓魂	嚇魂
关山月	關山月
缘觉	緣覺
点绛唇	點絳脣
掠影穹苍	掠影穹蒼
长生	長生
决灵	訣靈
崇云	崇雲
惊弦	驚弦
云中剑	雲中劍
秋声泠羽	秋聲泠羽
孤月无心	孤月無心
声若惊雷	聲若驚雷
势孤	勢孤
林寒涧肃	林寒澗肅
绝唱	絕唱
潜龙勿用	潛龍勿用
隐龙	隱龍
碎风刃	碎風刃
金戈回澜	金戈回瀾
骤雨寒江	驟雨寒江
血覆黄泉	血覆黃泉
乱天狼	亂天狼
隐风雷	隱風雷
日月吴钩	日月吳鉤
斩无常	斬無常
幽冥窥月	幽冥窺月
十方玄机	十方玄機
铁马冰河	鐵馬冰河
松寒	鬆寒
长绝	長絕
秋霁	秋霽
隐鳞	隱鱗
鸣剑	鳴劍
归鸿	歸鴻
云翳	雲翳
沥血	瀝血
风骨	風骨
荒云	荒雲
长恨	長恨
渊岳	淵嶽
玄肃	玄肅
殷炽	殷熾
龙胄	龍胄
王师	王師
忘断	忘斷
飞琼	飛瓊
闻鹤	聞鶴
百节	百節
凭临	憑臨
离楼	離樓
劫烬	劫燼
层楹	層楹
疑战	疑戰
横云意	橫雲意
孤风飒踏	孤風颯踏
不争	不爭
泾威	涇威
钗燕	釵燕
明齐日月	明齊日月
诛邪镇魔	誅邪鎮魔
锋鸣	鋒鳴
天堑	天塹
吴钩碎雪	吳鉤碎雪
北阙	北闕
套马	套馬
琼宵	瓊宵
归元	歸元
袍泽故旧	袍澤故舊
乐情	樂情
逍遥	逍遙
勇决	勇訣
广陵月	廣陵月
沁莲	沁蓮
生风	生風
以静	以靜
剑出鸿蒙	劍出鴻蒙
无间狱	無間獄
禅慧	禪慧
破军	破軍
蛊梦	蠱夢
云奔雨骤	雲奔雨驟
战骨	戰骨
三星临	三星臨
天斗旋	天鬥旋
奇门飞宫	奇門飛宮
鬼星开穴	鬼星開穴
返闭惊魂	返閉驚魂
斗转星移	斗轉星移
鸿蒙天禁	鴻蒙天禁
太玄经	太玄經
祝由·火离	祝由·火離
变卦	變卦
醍醐灌顶	醍醐灌頂
力破万钧	力破萬鈞
我闻	我聞
诸行	諸行
七宝	七寶
龙驭	龍馭
破国	破國
将命	將命
辅国	輔國
大针	大針
洛川神韵	洛川神韻
天网	天網
关锁	關鎖
相蚀	相蝕
连蜷	連蜷
虚实	虛實
无为	無為
裂云	裂雲
合虚	合虛
凌云剑	凌雲劍
萧瑟	蕭瑟
绰态	綽態
九微飞花	九微飛花
龙回首	龍回首
月出东山	月出東山
云石	雲石
雾腾	霧騰
岫烟	岫煙
祝祷	祝禱
神占	神佔
踏斗	踏鬥
顺祝	順祝
二圣	二聖
连缘蛊	連緣蠱
茧灵	繭靈
倾心	傾心
承华	承華
圣元阵	聖元陣
飞来闻踪	飛來聞蹤
枭神	梟神
荧入白	熒入白
天钺	天鉞
横断山河	橫斷山河
龙马出河	龍馬出河
河桥养箭	河橋養箭
灵机卸甲	靈機卸甲
储锋锐	儲鋒銳
鸩羽游	鴆羽遊
流火连星	流火連星
心机天成	心機天成
山风满楼	山風滿樓
巨门北落	巨門北落
华盖	華蓋
洞彻九宫	洞徹九宮
诡面埋伏	詭面埋伏
五明乐见	五明樂見
夷数神光	夷數神光
净体不畏	淨體不畏
具智离身	具智離身
微妙风	微妙風
灵器	靈器
杀星在尾	殺星在尾
复征	復徵
接舆	接輿
游君	遊君
凤歌	鳳歌
扶阵	扶陣
入阵	入陣
断马摧城	斷馬摧城
坚固	堅固
冻泉	凍泉
调律	調律
游太清	遊太清
绕梁	繞樑
霜轮	霜輪
惊鸿	驚鴻
掠关	掠關
临江	臨江
驾鸾	駕鸞
烟涛	煙濤
镜壁	鏡壁
连涯	連涯
飞倾列缺	飛傾列缺
渊秘	淵秘
修罗暗度	修羅暗度
崩决	崩訣
怜世人	憐世人
严阵	嚴陣
风遁	風遁
亘天	亙天
连断	連斷
征凶	徵凶
连极阵	連極陣
魂击	魂擊
含风	含風
渊冰	淵冰
月渡星汉	月渡星漢
晴昼	晴晝
若冲	若衝
钟灵	鍾靈
延气	延氣
镜花影	鏡花影
坚冰	堅冰
无间影狱	無間影獄
用御	用禦
诗上	詩上
肃列	肅列
砺锋	礪鋒
遗恨	遺恨
诸法空相	諸法空相
行云	行雲
鸿烈	鴻烈
神威穿彻	神威穿徹
裁叶饮刃	裁葉飲刃
灵素	靈素
无方	無方
银光照雪	銀光照雪
惊鸿掠水	驚鴻掠水
回风微澜	回風微瀾
商陆缀寒	商陸綴寒
钩吻断肠	鉤吻斷腸
奚毒射罔	川烏射罔
且待时休	且待時休
当归四逆	當歸四逆
龙葵自苦	龍葵自苦
灵素还生	靈素還生
含锋破月	含鋒破月
飞叶满襟	飛葉滿襟
凌然天风	凌然天風
千枝绽蕊	千枝綻蕊
苍棘缚地	蒼棘縛地
紫叶沉疴	紫葉沉痾
青川濯莲	青川濯蓮
逐云寒蕊	逐雲寒蕊
枯木苏息	枯木蘇息
绿野蔓生	綠野蔓生
潋滟	瀲灩
鸩羽	鴆羽
无可证	無可證
月见	月見
息缠	息纏
结草	結草
岚因	嵐因
逐鸿	逐鴻
藏丛	藏叢
断泽	斷澤
坚阴	堅陰
谢枝	謝枝
荆障	荊障
凄骨	悽骨
芳时	芳時
养荣	養榮
百叶	百葉
双生	雙生
滞眠	滯眠
连诛	連誅
渐苞	漸苞
铁骑	鐵騎
不负霜雪	不負霜雪
炮阳	炮陽
窃寒	竊寒
荡襟	蕩襟
陌归	陌歸
划云	劃雲
过涯	過涯
怒涌	怒湧
青圃着尘	青圃著塵
易险	易險
并蒂夺株	並蒂奪株
醒窍	醒竅
收涩	收澀
忘忧	忘憂
游泽	遊澤
韶时	韶時
绮栊	綺櫳
水苏	水蘇
相须	相須
释冰	釋冰
飘黄	飄黃
鸣震九霄	鳴震九霄
挂雨	掛雨
同梦	同夢
畅和	暢和
浅碧	淺碧
绿绦	綠絛
决明	決明
独活	獨活
织翠	織翠
胜娇	勝嬌
旋生飞草	旋生飛草
顾步	顧步
莲池	蓮池
辞零	辭零
卫矛	衛矛
百药宣时	百藥宣時
败叶	敗葉
拂怜	拂憐
无执	無執
温酒	溫酒
穿林打叶	穿林打葉
鹰扬虎视	鷹揚虎視
驾澜	駕瀾
澜升	瀾升
城复于隍	城復於隍
音彻	音徹
红绡倩风	紅綃倩風
敛意	斂意
矢尽兵穷	矢盡兵窮
游羽	遊羽
撼岳	撼嶽
剑锋百锻	劍鋒百鍛
鸿爪留泥	鴻爪留泥
飞刃回转	飛刃回轉
链魂	鏈魂
心诤	心諍
荨萼	蕁萼
灵荆	靈荊
茎蹊	莖蹊
潜香	潛香
篾片蛊	篾片蠱
无方中和	無方中和
灵素中和	靈素中和
凌叶飞霄	凌葉飛霄